###########################################################
# #   # # ###   #    # #  #   #   #      #  #  #  #  #  #B#
#   #   #   # # # # #  #    #   #   #  # #   # #  #  # #  #
# ##  # # # # #   # #  #  ################  #   # # # #  ##
# #   #   #   #   #  #   #                 #  #   # #  # ##
#   #  # #   #  #  #   #   ############### #  #  #   # #  #
# ##  ##  #    #    #  # #               #  #   #       # #
# #    #   #  #  #  ######################  #   #  # # #  #
# #### ### #  #  #   #   #   #   #   #   # #  #   #  ##   #
#          #  #  # #   #   #   #   #   # #    #  #      # #
#A#########################################################