#############
#          B#
# ######### #
# #       # #
# # ##### # #
#   #     # #
### # ##### #
A   #       #
#############